11111111
10100001
10001001
11111101
10001001
10000001
10000001
10100001
10100001
11111111
