12121212
10200001
20000102
10000201
10000002
10002121
21000002
12121212
