11111111
10100001
10000101
10000101
10000001
10001111
11000001
11111111
