111111111111111111111111111111
111000111100000000111100001111
111000111111111110111111101111
110000100000000000000000000001
110000100000000011111101111111
110111100000000010001000010001
100000000000000010111000011001
100000000000000010000000000001
100011111111111110000000000001
100011111110000000000000000001
111111111000011111111111111111
