1111111
1111111
1111111
1111011
1010011
1100011
1111111
1111111
1111111
